┌─┬─┬─┬─┬─┬───┬───┬─┬─┬─┬─┬─────┬───┬───┬─┬─┬─┬───┬─┬───┬─────┬───┬───┬─┬───────┐
│ │ │ │ │ │   │   │ │ │ │ │     │   │   │ │ │ │   │ │   │     │   │   │ │       │
│ ╵ ╵ ╵ │ ╵ ╷ │ ╷ ╵ │ │ ╵ │ ╶─┐ ╵ ╷ │ ╷ │ │ ╵ │ ╶─┘ ╵ ╷ ╵ ╶─┐ ╵ ┌─┼─╴ ╵ ╵ ╶─┐ ╷ │
│       │   │ │ │   │ │   │   │   │ │ │ │ │   │       │     │   │ │         │ │ │
│ ╶───┬─┤ ╷ │ ╵ └─┐ │ └─╴ │ ╷ │ ┌─┤ │ ├─┘ └─╴ ╵ ╶─┐ ╶─┤ ╷ ╶─┴─┐ ╵ │ ╷ ┌─╴ ┌─┼─┼─┤
│     │ │ │ │     │ │     │ │ │ │ │ │ │           │   │ │     │   │ │ │   │ │ │ │
│ ╶─┐ ╵ ├─┴─┴─╴ ╶─┤ │ ┌─╴ ╵ │ ├─┤ ╵ ╵ ╵ ╶─┐ ╷ ╷ ┌─┼───┴─┼─╴ ╷ ├───┼─┴─┤ ╷ ╵ ╵ ╵ │
│   │   │         │ │ │     │ │ │         │ │ │ │ │     │   │ │   │   │ │       │
├───┘ ╷ └─┬───╴ ┌─┘ └─┤ ╶─┐ │ │ ╵ ╷ ╷ ╷ ┌─┴─┤ ├─┘ ├─╴ ┌─┴─╴ ├─┤ ╷ └─╴ ╵ └───────┤
│     │   │     │     │   │ │ │   │ │ │ │   │ │   │   │     │ │ │               │
│ ┌─┬─┘ ╷ │ ╷ ┌─┘ ┌─┬─┴─╴ └─┼─┼─╴ ├─┘ └─┴─┐ ╵ └─╴ │ ╶─┴─┐ ╷ │ └─┘ ┌─┐ ╶───┐ ╶───┤
│ │ │   │ │ │ │   │ │       │ │   │       │       │     │ │ │     │ │     │     │
│ │ ╵ ╷ │ └─┼─┼─╴ ╵ └─╴ ╶─┐ │ ├─┐ │ ╷ ╷ ┌─┘ ╶─┬─┐ ╵ ╷ ╶─┤ ├─┘ ┌─┐ │ └───┬─┴─┐ ╶─┤
│ │   │ │   │ │           │ │ │ │ │ │ │ │     │ │   │   │ │   │ │ │     │   │   │
├─┘ ╷ │ └─┐ │ └─┬─────╴ ╶─┼─┘ │ ╵ │ ├─┴─┘ ╷ ┌─┘ │ ╶─┼─╴ ├─┘ ╶─┘ ├─┴───┐ └─╴ └─╴ │
│   │ │   │ │   │         │   │   │ │     │ │   │   │   │       │     │         │
│ ╶─┤ └─┐ │ ╵ ╷ ╵ ┌─┬───╴ ├─╴ │ ╷ │ │ ┌─╴ │ ╵ ┌─┼─┬─┼─┐ └─╴ ╶───┴─╴ ╷ ├─┬───┐ ╶─┤
│   │   │ │   │   │ │     │   │ │ │ │ │   │   │ │ │ │ │             │ │ │   │   │
├───┘ ╷ │ │ ┌─┴─╴ ╵ └─┬─╴ └─┐ └─┴─┼─┴─┤ ╷ └───┤ ╵ ╵ │ │ ╶─┬─┬───╴ ╶─┤ ╵ │ ╷ └─┐ │
│     │ │ │ │         │     │     │   │ │     │     │ │   │ │       │   │ │   │ │
│ ╷ ╶─┤ ├─┼─┘ ┌─╴ ╶─┬─┴─┐ ┌─┘ ┌─╴ │ ╶─┼─┘ ╶─┬─┴─┬─╴ ╵ ├───┘ ├─╴ ┌─┬─┴─╴ ├─┤ ╶─┘ │
│ │   │ │ │   │     │   │ │   │   │   │     │   │     │     │   │ │     │ │     │
│ │ ╷ ├─┘ ╵ ╶─┤ ┌─┬─┴─╴ └─┘ ┌─┘ ╶─┴─┐ │ ╶───┘ ╶─┘ ┌─╴ └─┐ ╶─┴─╴ ╵ ├───┬─┤ │ ╷ ╷ │
│ │ │ │       │ │ │         │       │ │           │     │         │   │ │ │ │ │ │
│ ├─┴─┼─┐ ╷ ┌─┼─┤ └───╴ ╷ ╷ ├─┐ ╶─┐ ╵ └─┐ ╷ ╶─────┤ ╷ ┌─┘ ╷ ┌─────┴─╴ ╵ ╵ └─┤ └─┤
│ │   │ │ │ │ │ │       │ │ │ │   │     │ │       │ │ │   │ │               │   │
│ ╵ ╶─┤ ├─┘ │ ╵ │ ╷ ╷ ┌─┘ └─┘ ├─╴ │ ┌───┼─┴─┬─────┴─┘ │ ╷ │ └─┬─╴ ┌─╴ ╷ ╶─┐ └─╴ │
│     │ │   │   │ │ │ │       │   │ │   │   │         │ │ │   │   │   │   │     │
├─────┘ │ ╶─┼─╴ │ └─┴─┼─┐ ╷ ┌─┴───┤ ├─╴ ╵ ╷ └─╴ ┌─────┴─┴─┴─┬─┘ ┌─┤ ╶─┤ ╶─┤ ╷ ╶─┤
│       │   │   │     │ │ │ │     │ │     │     │           │   │ │   │   │ │   │
├─╴ ╷ ╷ │ ┌─┤ ╷ ╵ ┌─╴ ╵ └─┼─┘ ┌─╴ └─┴─────┘ ┌─┐ └─┬─╴ ┌─┐ ┌─┴─╴ ╵ └───┴─┬─┤ │ ╷ │
│   │ │ │ │ │ │   │       │   │             │ │   │   │ │ │             │ │ │ │ │
├───┴─┘ ╵ │ ├─┘ ╶─┤ ╶───┬─┘ ╷ │ ╶─┐ ╷ ╷ ┌─┬─┘ └───┤ ╶─┤ ╵ │ ┌───┐ ╶─┬─┬─┘ └─┴─┴─┤
│         │ │     │     │   │ │   │ │ │ │ │       │   │   │ │   │   │ │         │
├───┐ ╷ ┌─┤ └─┬───┤ ╶───┼─┐ └─┼───┤ └─┤ │ ╵ ╶─────┴───┘ ┌─┤ └─╴ └─┐ ╵ ╵ ┌─╴ ╷ ╶─┤
│   │ │ │ │   │   │     │ │   │   │   │ │               │ │       │     │   │   │
├─╴ │ ├─┘ ╵ ╶─┘ ╶─┤ ┌───┘ ├─┐ ╵ ╷ │ ╶─┴─┘ ┌───╴ ╶─┬───╴ ╵ ├─╴ ┌───┤ ╶───┼───┴─╴ │
│   │ │           │ │     │ │   │ │       │       │       │   │   │     │       │
│ ╶─┘ └─╴ ┌─╴ ╶─┬─┘ └─╴ ╷ ╵ ╵ ┌─┘ ├─╴ ╶─┬─┘ ╶─┐ ┌─┘ ╷ ╶─┬─┘ ╷ ╵ ╷ └───┬─┴───╴ ╶─┤
│         │     │       │     │   │     │     │ │   │   │   │   │     │         │
└─────────┴─────┴───────┴─────┴───┴─────┴─────┴─┴───┴───┴───┴───┴─────┴─────────┘
